#----#-----#-###------#-#-#-##---------#----#--#--
#--##-#-##-#--#---#--------###-#--------#-#--#-#--
#O###-#-----------##-------#-###-#----#---###-#-#-
----##----##-#----#---#--#--#---#-#---#--###--###-
#------#--#---###--#---####---#---###--#----------
##-#-#-#-#####-##--##-##-#--##-#-##-##--#----#----
-#----##-#--##------###--###---##-#-#----####-##--
##--#-----#----#------#--#--#-#--#-##--#-#-#------
#----####---#-##-----##--#----##---#---------#---#
--#--#---##-#-----##---#-----#-#-------------##-#-
#########------#---#-#-#----#-##----#-#--------##-
-----##--#---##-----#--------#----##---#-#--#---#-
###--------##-#-#-#----#----#-##-####------#--#--#
-##---#-#----##--#-###--##------#-#---#-------#-#-
--##---#-----#---##---#--#--------#-#-----###--###
-#-####-###-------------#-#---#---#----###--#-#-#-
##-##--#-#-##-#----#---#-#-----#--#---##--#---#-##
---------###-####--#####--###-#--------##---##----
-###---#-####--#-----##--###--###--##-#####-#-##--
#---###---###-#-#--#---##----##-------#-#---##----
-#-#-----###-###-------#------##----#---#--#-----#
-#--##------#-##---#-##-#-#--#-#-#----#-----#--#--
-###---#-#-#---#--#-#---###-#-##------#-##-----#-#
#------#--#--##-#------##--#---#-----#-#----#-----
-----##--##--#-##-#-#--#--#-####------#-#-#-###--#
#-##-#----#-##------#--#--#-----##--#---#--#----#-
--#------##-##-##--#----#--###--##----##----#----#
---#---#-----#----##-#--#--#-###-###-------------#
---#----#-##----#-##--##-#-###-#--#--##--##-------
-#--#-#-#--#----#--#-#---#--###----#-#-##------##-
----#----#---##--##---#--#------------#----#-##---
--#-#-#-###--#-#----#-----##--##-#-----##-#----##-
----##----#-#-##------#--#-#-###-#---#-###-#-----#
----#--###---#-#--####---#---####-#--------##--#--
---####---------------#--#-#--#-#---###-----####--
--##-#-#---#---#-#-#--#----##-#-----###--##-#---#-
--#--#--#---#--------#--#-----##---##--#-#----#-#-
-###-#-#---#-#---#--##--#---##-#-----##---------##
-##-##---#---##-#--#------#-#-#---#---#-##-----#--
--#-#---#---##-##--#-#--#-###---#-----#-#-#-#-#---
-##-##----#-#-#---##-----###-----#-#-----###-#--##
----#-#--#-#-##-#---#-##--#####-##-#-----#------##
###-#-#----#--#-#-#-----#--#-####-#-###----#-#----
--#---#-#-#--##---##-------------#-#---##--#-#-#-#
----#----#####-------##--###---------------##---##
###-#-#-##--###-#-#-#--###---#-#----#----------##-
-#-------###--#-#-##----##-----##---#--#---#-#-#--
---##--------#-#----###-----#---#--#---#-#----#---
#-----#--##-#-###----##---#-##-###-#-###-#--------
#-#-#--##-###-###-#####-#----#-##---#--#-----#-#--
